0
3
153 974 581 1116 1116 1116 499 315 372 372 372 372 372 372 372 400 0 0 0 399 372 435 436 437 623 624 625 1610613387
181 862 471 0 444 132 132 132 132 132 447 0 0 0 0 0 0 0 0 0 0 0 0 0 0 0 0 18
862 862 471 0 472 0 0 0 0 0 475 0 0 0 0 0 0 0 0 0 0 0 0 0 0 0 0 18
525 525 499 35 472 0 0 0 0 0 475 438 435 436 437 35 35 35 35 35 35 35 0 0 0 0 0 64
382 444 0 0 0 0 0 0 0 0 0 51 52 0 0 0 0 0 0 0 0 0 447 0 0 0 0 64
410 472 0 0 0 0 0 0 0 0 0 79 80 0 0 0 0 0 0 0 0 0 475 0 0 0 0 18
438 472 0 0 0 0 0 0 0 0 0 0 0 0 0 0 0 0 0 0 0 0 475 0 0 0 0 43
492 472 0 0 0 0 0 0 0 0 0 0 0 0 0 0 0 106 0 0 0 106 475 0 0 0 0 71
520 472 0 51 52 0 0 0 0 0 0 0 0 0 0 0 0 272 0 0 0 276 475 9 0 0 0 99
494 472 0 79 80 0 0 0 0 0 0 0 0 0 0 51 52 300 0 0 0 304 475 0 0 0 0 127
522 472 0 0 0 0 0 0 0 0 0 0 0 0 0 79 80 328 0 0 0 332 475 0 0 0 0 267
550 500 584 585 529 529 529 529 529 529 529 529 529 529 529 529 529 356 0 0 0 360 503 0 0 0 0 295
520 513 500 503 0 0 0 0 0 0 0 0 0 0 0 0 0 384 0 0 0 388 0 0 0 0 438 323
548 438 438 438 108 0 0 0 0 0 0 0 0 0 0 0 0 0 0 0 0 0 0 0 0 438 444 447
64 64 64 400 316 316 316 316 316 316 316 316 316 316 316 317 64 64 64 11 124 124 124 124 124 125 500 503
